//////////////////////////////////////////////////////////////////////////////////////////////////////////////////////////////////////////////////////////////////////////////////////////////////////
//////////////////////////////////////////////////////////////////////////////////////////////////////////////////////////////////////////////////////////////////////////////////////////////////////
//////////////////////////////////////////////////////////////////////////////////////////////////////////////////////////////////////////////////////////////////////////////////////////////////////
//////////////////////////////////////////////////////////////////////////////////////////////////////////////////////////////////////////////////////////////////////////////////////////////////////
/////////////////////////////////////////////////                                                                                                 ////////////////////////////////////////////////////
/////////////////////////////////////////////////                                                                                                 ////////////////////////////////////////////////////
/////////////////////////////////////////////////                                                                                                 ////////////////////////////////////////////////////
/////////////////////////////////////////////////                                                                                                 ////////////////////////////////////////////////////
/////////////////////////////////////////////////                                                                                                 ////////////////////////////////////////////////////
/////////////////////////////////////////////////                                                                                                 ////////////////////////////////////////////////////
/////////////////////////////////////////////////                                                                                                 ////////////////////////////////////////////////////
/////////////////////////////////////////////////                                                                                                 ////////////////////////////////////////////////////
/////////////////////////////////////////////////                                                                                                 ////////////////////////////////////////////////////
/////////////////////////////////////////////////                                                                                                 ////////////////////////////////////////////////////
/////////////////////////////////////////////////                                                                                                 ////////////////////////////////////////////////////
/////////////////////////////////////////////////                                                                                                 ////////////////////////////////////////////////////
/////////////////////////////////////////////////                                                                                                 ////////////////////////////////////////////////////
/////////////////////////////////////////////////                                                                                                 ////////////////////////////////////////////////////
/////////////////////////////////////////////////                                                                                                 ////////////////////////////////////////////////////
/////////////////////////////////////////////////                                                                                                 ////////////////////////////////////////////////////
/////////////////////////////////////////////////                                                                                                 ////////////////////////////////////////////////////
/////////////////////////////////////////////////                                                                                                 ////////////////////////////////////////////////////
/////////////////////////////////////////////////                                                                                                 ////////////////////////////////////////////////////
/////////////////////////////////////////////////                                                                                                 ////////////////////////////////////////////////////
/////////////////////////////////////////////////                                                                                                 ////////////////////////////////////////////////////
/////////////////////////////////////////////////                                                                                                 ////////////////////////////////////////////////////
/////////////////////////////////////////////////                                                                                                 ////////////////////////////////////////////////////
/////////////////////////////////////////////////                                                                                                 ////////////////////////////////////////////////////
/////////////////////////////////////////////////                                                                                                 ////////////////////////////////////////////////////
/////////////////////////////////////////////////                                                                                                 ////////////////////////////////////////////////////
/////////////////////////////////////////////////                                                                                                 ////////////////////////////////////////////////////
/////////////////////////////////////////////////                                                                                                 ////////////////////////////////////////////////////
/////////////////////////////////////////////////                                                                                                 ////////////////////////////////////////////////////
/////////////////////////////////////////////////                                                                                                 ////////////////////////////////////////////////////
/////////////////////////////////////////////////                                                                                                 ////////////////////////////////////////////////////
/////////////////////////////////////////////////                                                                                                 ////////////////////////////////////////////////////
/////////////////////////////////////////////////                                                                                                 ////////////////////////////////////////////////////
/////////////////////////////////////////////////                                                                                                 ////////////////////////////////////////////////////
/////////////////////////////////////////////////                                                                                                 ////////////////////////////////////////////////////
/////////////////////////////////////////////////                                                                                                 ////////////////////////////////////////////////////
///////////////////////////////////////////////////////////////////////////////////////////////////                         //////////////////////////////////////////////////////////////////////////
///////////////////////////////////////////////////////////////////////////////////////////////////                         //////////////////////////////////////////////////////////////////////////
///////////////////////////////////////////////////////////////////////////////////////////////////                         //////////////////////////////////////////////////////////////////////////
///////////////////////////////////////////////////////////////////////////////////////////////////                         //////////////////////////////////////////////////////////////////////////
///////////////////////////////////////////////////////////////////////////////////////////////////                         //////////////////////////////////////////////////////////////////////////
///////////////////////////////////////////////////////////////////////////////////////////////////                         //////////////////////////////////////////////////////////////////////////
///////////////////////////////////////////////////////////////////////////////////////////////////                         //////////////////////////////////////////////////////////////////////////
///////////////////////////////////////////////////////////////////////////////////////////////////                         //////////////////////////////////////////////////////////////////////////
///////////////////////////////////////////////////////////////////////////////////////////////////                         //////////////////////////////////////////////////////////////////////////
///////////////////////////////////////////////////////////////////////////////////////////////////                         //////////////////////////////////////////////////////////////////////////
///////////////////////////////////////////////////////////////////////////////////////////////////                         //////////////////////////////////////////////////////////////////////////
///////////////////////////////////////////////////////////////////////////////////////////////////                         //////////////////////////////////////////////////////////////////////////
///////////////////////////////////////////////////////////////////////////////////////////////////                         //////////////////////////////////////////////////////////////////////////
///////////////////////////////////////////////////////////////////////////////////////////////////                         //////////////////////////////////////////////////////////////////////////
///////////////////////////////////////////////////////////////////////////////////////////////////                         //////////////////////////////////////////////////////////////////////////
///////////////////////////////////////////////////////////////////////////////////////////////////                         //////////////////////////////////////////////////////////////////////////
///////////////////////////////////////////////////////////////////////////////////////////////////                         //////////////////////////////////////////////////////////////////////////
///////////////////////////////////////////////////////////////////////////////////////////////////                         //////////////////////////////////////////////////////////////////////////
///////////////////////////////////////////////////////////////////////////////////////////////////                         //////////////////////////////////////////////////////////////////////////
///////////////////////////////////////////////////////////////////////////////////////////////////                         //////////////////////////////////////////////////////////////////////////
///////////////////////////////////////////////////////////////////////////////////////////////////                         //////////////////////////////////////////////////////////////////////////
///////////////////////////////////////////////////////////////////////////////////////////////////                         //////////////////////////////////////////////////////////////////////////
///////////////////////////////////////////////////////////////////////////////////////////////////            2            //////////////////////////////////////////////////////////////////////////
//////////////////////////////////////////////////////////////////////////////////////////////////////////////////////////////////////////////////////////////////////////////////////////////////////
//////////////////////////////////////////////////////////////////////////////////////////////////////////////////////////////////////////////////////////////////////////////////////////////////////
