//////////////////////////////////////////////////////////////////////////////////////////////////////////////////////////////////////////////////////////////////////////////////////////////////////
//////////////////////////////////////////////////////////////////////////////////////////////////////////////////////////////////////////////////////////////////////////////////////////////////////
///////////////////////////////////////////////////////////////////////////////////////////////////          1              //////////////////////////////////////////////////////////////////////////
///////////////////////////////////////////////////////////////////////////////////////////////////                         //////////////////////////////////////////////////////////////////////////
///////////////////////////////////////////////////////////////////////////////////////////////////                         //////////////////////////////////////////////////////////////////////////
///////////////////////////////////////////////////////////////////////////////////////////////////                         //////////////////////////////////////////////////////////////////////////
///////////////////////////////////////////////////////////////////////////////////////////////////                         //////////////////////////////////////////////////////////////////////////
///////////////////////////////////////////////////////////////////////////////////////////////////                         //////////////////////////////////////////////////////////////////////////
///////////////////////////////////////////////////////////////////////////////////////////////////                         //////////////////////////////////////////////////////////////////////////
///////////////////////////////////////////////////////////////////////////////////////////////////                         //////////////////////////////////////////////////////////////////////////
///////////////////////////////////////////////////////////////////////////////////////////////////                         //////////////////////////////////////////////////////////////////////////
///////////////////////////////////////////////////////////////////////////////////////////////////                         //////////////////////////////////////////////////////////////////////////
///////////////////////////////////////////////////////////////////////////////////////////////////                         //////////////////////////////////////////////////////////////////////////
///////////////////////////////////////////////////////////////////////////////////////////////////                         //////////////////////////////////////////////////////////////////////////
///////////////////////////////////////////////////////////////////////////////////////////////////                         //////////////////////////////////////////////////////////////////////////
///////////////////////////////////////////////////////////////////////////////////////////////////                         //////////////////////////////////////////////////////////////////////////
///////////////////////////////////////////////////////////////////////////////////////////////////                         //////////////////////////////////////////////////////////////////////////
///////////////////////////////////////////////////////////////////////////////////////////////////                         //////////////////////////////////////////////////////////////////////////
///////////////////////////////////////////////////////////////////////////////////////////////////                         //////////////////////////////////////////////////////////////////////////
///////////////////////////////////////////////////////////////////////////////////////////////////                         //////////////////////////////////////////////////////////////////////////
///////////////////////////////////////////////////////////////////////////////////////////////////                         //////////////////////////////////////////////////////////////////////////
///////////////////////////////////////////////////////////////////////////////////////////////////                         //////////////////////////////////////////////////////////////////////////
/////////////////////////////////////////////////                                                                                                 ////////////////////////////////////////////////////
/////////////////////////////////////////////////                                                                                                 ////////////////////////////////////////////////////
/////////////////////////////////////////////////                                                                                                 ////////////////////////////////////////////////////
/////////////////////////////////////////////////                                                                                                 ////////////////////////////////////////////////////
/////////////////////////////////////////////////                                                                                                 ////////////////////////////////////////////////////
/////////////////////////////////////////////////                                                                                                 ////////////////////////////////////////////////////
/////////////////////////////////////////////////                                                                                                 ////////////////////////////////////////////////////
/////////////////////////////////////////////////                                                                                                 ////////////////////////////////////////////////////
/////////////////////////////////////////////////                                                                                                 ////////////////////////////////////////////////////
/////////////////////////////////////////////////                                                                                                 ////////////////////////////////////////////////////
/////////////////////////////////////////////////                                                                                                 ////////////////////////////////////////////////////
/////////////////////////////////////////////////                                                                                                 ////////////////////////////////////////////////////
/////////////////////////////////////////////////                                                                                                 ////////////////////////////////////////////////////
/////////////////////////////////////////////////                                                                                                 ////////////////////////////////////////////////////
/////////////////////////////////////////////////                                                                                                 ////////////////////////////////////////////////////
/////////////////////////////////////////////////                                                                                                 ////////////////////////////////////////////////////
/////////////////////////////////////////////////                                                                                                 ////////////////////////////////////////////////////
/////////////////////////////////////////////////                                                                                                 ////////////////////////////////////////////////////
/////////////////////////////////////////////////////////////////////////////////////////                                   //////////////////////////////////////////////////////////////////////////
/////////////////////////////////////////////////////////////////////////////////////////                                   //////////////////////////////////////////////////////////////////////////
/////////////////////////////////////////////////////////////////////////////////////////                                   //////////////////////////////////////////////////////////////////////////
/////////////////////////////////////////////////////////////////////////////////////////                                   //////////////////////////////////////////////////////////////////////////
/////////////////////////////////////////////////////////////////////////////////////////                                   //////////////////////////////////////////////////////////////////////////
/////////////////////////////////////////////////////////////////////////////////////////                                   //////////////////////////////////////////////////////////////////////////
/////////////////////////////////////////////////////////////////////////////////////////                                   //////////////////////////////////////////////////////////////////////////
/////////////////////////////////////////////////////////////////////////////////////////                                   //////////////////////////////////////////////////////////////////////////
/////////////////////////////////////////////////////////////////////////////////////////                                   //////////////////////////////////////////////////////////////////////////
/////////////////////////////////////////////////////////////////////////////////////////                                   //////////////////////////////////////////////////////////////////////////
/////////////////////////////////////////////////////////////////////////////////////////                                   //////////////////////////////////////////////////////////////////////////
/////////////////////////////////////////////////////////////////////////////////////////                                   //////////////////////////////////////////////////////////////////////////
/////////////////////////////////////////////////////////////////////////////////////////                                   //////////////////////////////////////////////////////////////////////////
/////////////////////////////////////////////////////////////////////////////////////////                                   //////////////////////////////////////////////////////////////////////////
/////////////////////////////////////////////////////////////////////////////////////////                                   //////////////////////////////////////////////////////////////////////////
/////////////////////////////////////////////////////////////////////////////////////////                                   //////////////////////////////////////////////////////////////////////////
/////////////////////////////////////////////////////////////////////////////////////////                                   //////////////////////////////////////////////////////////////////////////
/////////////////////////////////////////////////////////////////////////////////////////                                   //////////////////////////////////////////////////////////////////////////
/////////////////////////////////////////////////////////////////////////////////////////                                   //////////////////////////////////////////////////////////////////////////
/////////////////////////////////////////////////////////////////////////////////////////                                   //////////////////////////////////////////////////////////////////////////
/////////////////////////////////////////////////////////////////////////////////////////                                   //////////////////////////////////////////////////////////////////////////
/////////////////////////////////////////////////////////////////////////////////////////                                   //////////////////////////////////////////////////////////////////////////
/////////////////////////////////////////////////////////////////////////////////////////                                   //////////////////////////////////////////////////////////////////////////
//////////////////////////////////////////////////////////////////////////////////////////////////////////////////////////////////////////////////////////////////////////////////////////////////////
//////////////////////////////////////////////////////////////////////////////////////////////////////////////////////////////////////////////////////////////////////////////////////////////////////
