//////////////////////////////////////////////////////////////////////////////////////////////////////////////////////////////////////////////////////////////////////////////////////////////////////
//////////////////////////////////////////////////////////////////////////////////////////////////////////////////////////////////////////////////////////////////////////////////////////////////////
///////////////////////////////////////////////////////////////////////////////////////////////////                         //////////////////////////////////////////////////////////////////////////
///////////////////////////////////////////////////////////////////////////////////////////////////                         //////////////////////////////////////////////////////////////////////////
///////////////////////////////////////////////////////////////////////////////////////////////////                         //////////////////////////////////////////////////////////////////////////
///////////////////////////////////////////////////////////////////////////////////////////////////                         //////////////////////////////////////////////////////////////////////////
///////////////////////////////////////////////////////////////////////////////////////////////////                         //////////////////////////////////////////////////////////////////////////
///////////////////////////////////////////////////////////////////////////////////////////////////                         //////////////////////////////////////////////////////////////////////////
///////////////////////////////////////////////////////////////////////////////////////////////////                         //////////////////////////////////////////////////////////////////////////
///////////////////////////////////////////////////////////////////////////////////////////////////                         //////////////////////////////////////////////////////////////////////////
///////////////////////////////////////////////////////////////////////////////////////////////////                         //////////////////////////////////////////////////////////////////////////
///////////////////////////////////////////////////////////////////////////////////////////////////                         //////////////////////////////////////////////////////////////////////////
///////////////////////////////////////////////////////////////////////////////////////////////////                         //////////////////////////////////////////////////////////////////////////
///////////////////////////////////////////////////////////////////////////////////////////////////                         //////////////////////////////////////////////////////////////////////////
///////////////////////////////////////////////////////////////////////////////////////////////////                         //////////////////////////////////////////////////////////////////////////
///////////////////////////////////////////////////////////////////////////////////////////////////                                                                                               ////
///////////////////////////////////////////////////////////////////////////////////////////////////                                                                                               ////
///////////////////////////////////////////////////////////////////////////////////////////////////                                                                                          1    ////
///////////////////////////////////////////////////////////////////////////////////////////////////                                                                                               ////
///////////////////////////////////////////////////////////////////////////////////////////////////                                                                                               ////
///////////////////////////////////////////////////////////////////////////////////////////////////                                                                                               ////
///////////////////////////////////////////////////////////////////////////////////////////////////                                                                                               ////
/////////////////////////////////////////////////                                                                                                 ////////////////////////////////////////////////////
/////////////////////////////////////////////////                                                                                                 ////////////////////////////////////////////////////
/////////////////////////////////////////////////                                                                                                 ////////////////////////////////////////////////////
/////////////////////////////////////////////////                                                                                                 ////////////////////////////////////////////////////
/////////////////////////////////////////////////                                                                                                 ////////////////////////////////////////////////////
/////////////////////////////////////////////////                                                                                                 ////////////////////////////////////////////////////
/////////////////////////////////////////////////                                                                                                 ////////////////////////////////////////////////////
/////////////////////////////////////////////////                                                                                                 ////////////////////////////////////////////////////
/////////////////////////////////////////////////                                                                                                 ////////////////////////////////////////////////////
/////////////////////////////////////////////////                                                                                                 ////////////////////////////////////////////////////
/////////////////////////////////////////////////                                                                                                 ////////////////////////////////////////////////////
/////////////////////////////////////////////////                                                                                                 ////////////////////////////////////////////////////
/////////////////////////////////////////////////                                                                                                 ////////////////////////////////////////////////////
/////////////////////////////////////////////////                                                                                                 ////////////////////////////////////////////////////
/////////////////////////////////////////////////                                                                                                 ////////////////////////////////////////////////////
/////////////////////////////////////////////////                                                                                                 ////////////////////////////////////////////////////
/////////////////////////////////////////////////                                                                                                 ////////////////////////////////////////////////////
/////////////////////////////////////////////////                                                                                                 ////////////////////////////////////////////////////
/////////////////////////////////////////////////////////////////////////////////////////                                   //////////////////////////////////////////////////////////////////////////
/////////////////////////////////////////////////////////////////////////////////////////                                   //////////////////////////////////////////////////////////////////////////
/////////////////////////////////////////////////////////////////////////////////////////                                   //////////////////////////////////////////////////////////////////////////
/////////////////////////////////////////////////////////////////////////////////////////                                   //////////////////////////////////////////////////////////////////////////
/////////////////////////////////////////////////////////////////////////////////////////                                   //////////////////////////////////////////////////////////////////////////
/////////////////////////////////////////////////////////////////////////////////////////                                   //////////////////////////////////////////////////////////////////////////
/////////////////////////////////////////////////////////////////////////////////////////                                   //////////////////////////////////////////////////////////////////////////
/////////////////////////////////////////////////////////////////////////////////////////                                   //////////////////////////////////////////////////////////////////////////
/////////////////////////////////////////////////////////////////////////////////////////                                   //////////////////////////////////////////////////////////////////////////
/////////////////////////////////////////////////////////////////////////////////////////                                   //////////////////////////////////////////////////////////////////////////
/////////////////////////////////////////////////////////////////////////////////////////                                   //////////////////////////////////////////////////////////////////////////
/////////////////////////////////////////////////////////////////////////////////////////                                   //////////////////////////////////////////////////////////////////////////
/////////////////////////////////////////////////////////////////////////////////////////                                   //////////////////////////////////////////////////////////////////////////
/////////////////////////////////////////////////////////////////////////////////////////                                   //////////////////////////////////////////////////////////////////////////
/////////////////////////////////////////////////////////////////////////////////////////                                   //////////////////////////////////////////////////////////////////////////
/////////////////////////////////////////////////////////////////////////////////////////                                   //////////////////////////////////////////////////////////////////////////
/////////////////////////////////////////////////////////////////////////////////////////                                   //////////////////////////////////////////////////////////////////////////
/////////////////////////////////////////////////////////////////////////////////////////                                   //////////////////////////////////////////////////////////////////////////
/////////////////////////////////////////////////////////////////////////////////////////                                   //////////////////////////////////////////////////////////////////////////
/////////////////////////////////////////////////////////////////////////////////////////                                   //////////////////////////////////////////////////////////////////////////
/////////////////////////////////////////////////////////////////////////////////////////                                   //////////////////////////////////////////////////////////////////////////
/////////////////////////////////////////////////////////////////////////////////////////                                   //////////////////////////////////////////////////////////////////////////
/////////////////////////////////////////////////////////////////////////////////////////                                   //////////////////////////////////////////////////////////////////////////
//////////////////////////////////////////////////////////////////////////////////////////////////////////////////////////////////////////////////////////////////////////////////////////////////////
//////////////////////////////////////////////////////////////////////////////////////////////////////////////////////////////////////////////////////////////////////////////////////////////////////
